cheetah	a
coke	a
etc	abandon
altitude	abandoned
intentionally	abandoned
fairy-tale	abandoned
contend	able
seatbelts	aboard
bullfighting	abolish
washbasin	above
jelly	abrupt
perishable	abrupt
defendant	absence
funkier	absolutely
bloodstream	absorb
intermingled	absorb
discord	abusive
rupture	abusive
acute	accent
wo	accept
socially	acceptable
groceries	acceptance
internet	access
furnishings	accessory
archeological	accidental
songwriter	acclaimed
inconsistency	acclaimed
recital	accompany
exemplary	account
reservoir	accumulate
horseback	ache
chemically	acid
hydrochloric	acid
dragon	acid
interpreter	acknowledge
correspondence	acknowledge
advisable	act
compensation	action
smoothed	action
canyon	action
mountainous	active
unidentified	active
volcanic	active
de	actor
seafood	actually
halfpipe	actually
funbox	actually
ramps	actually
manto	add
chili	add
counterproductive	add
heroin	addict
standstill	addictive
villa	addition
popcorn	addition
subtraction	addition
xxxxxxxxx	address
inhaled	address
everyday	adequate
lenses	adjust
tapes	adjust
ex-army	administrator
muscular	admiration
secretive	adolescent
light-hearted	adopt
non-violent	advocate
fascism	advocate
subscribe	advocate
attentive	affectionate
stereo	afford
smugglers	against
doorbell	ago
schoolmates	ahead
scholastic	ahead
pursuits	ahead
millionaire	aim
agricultural	aim
axe	air
couch	air
evacuate	alarm
damped	alarm
loony-left	alarm
frequency	alarming
hampered	albeit
tagging	albeit
lager	alcohol
playful	alert
alienation	alert
estranged	alert
feminism	alive
stomachs	all
rumble	all
misconduct	allegation
perpetual	allege
downpour	alleged
patrolling	allied
vs	allocation
traitor	allowance
skyline	alongside
chairlifts	alternative
funicular-railway	alternative
baht	altogether
foil	aluminium
zinc	aluminium
joyful	amid
unsubjected	amid
carpe	amid
diem	amid
yourselves	among
clips	amuse
surrealistic	amuse
novella	amuse
crosswords	amuse
au	an
petroleum	analogous
hurdles	analogous
dependency	analogy
contamination	analyse
footage	anchor
unmoving	anchor
solidified	anchor
takeoff	angle
sloping	angle
processor	angle
mains	angle
socket	angle
tilt	angle
zoom	angle
superhero	animated
sprained	ankle
fiftieth	anniversary
toaster	another
unpleasantness	antibiotic
spoonful	antibiotic
breathless	anticipation
fairy	anticipation
negatives	any
spaghetti	anything
bolognese	anything
lasagne	anything
hamburger	anywhere
minibuses	anywhere
belated	apology
handicapped	appalling
brutality	appalling
pubescent	appalling
metro	apparent
year-olds	appeal
degenerated	appetite
blood-lust	appetite
sportswear	appliance
hangars	application
zero-gravity	application
colonies	application
mistreat	apply
governmental	approval
savagery	arbitrary
curved	arch
courtyard	arch
expertise	area
invigorating	arid
oasis	arid
pierced	arm
curfew	army
pianist	around
sporting	around
childcare	arrangement
await	arrival
boxer	arrival
bloomed	arrogant
axes	arrow
crossbows	arrow
flavourings	artificial
illumination	artificial
unselfishness	artificial
manure	artificially
crunch	as
professionally	as
feng	as
shui	as
currrently	as
rooted	as
inherently	as
amorphous	as
hooligans	assault
skiers	assemble
climbers	assemble
snowboarder	assemble
course-takers	assemble
automated	assembly
pangs	assert
homesickness	assert
freelance	assignment
genre	association
acquisition	assurance
martin	at
mozilla	at
org	at
slalom	at
mph	at
loner	at
hospitalized	at
destructive	at
irrelevant	at
implicitly	at
boisterous	at
derision	at
outward	at
nemesis	at
municipality	at
gloom	atmosphere
stuffy	atmosphere
molecule	atom
radioactive	atomic
surfer	attached
grinding	attachment
myriad	attack
super	attack
mutant	attack
aliens	attack
scathing	attack
gala	attendance
toward	attitude
sexually	attract
raffles	auction
untalented	audition
subtly	authentic
ex-wives	authority
seventeenth-century	authority
airconditioned	authorize
remedial	authorize
freelyavailable	available
demonstrators	avenue
despise	avoid
km	away
fatigued	away
hammering	away
sheepishly	awesome
spectacles	awkward
inn	back
forth	back
mermaids	back
ivory	back
jumble	back
oriental	background
hovered	background
lugging	bad
rupees	badly
unencumbered	baggage
freshly	bake
preheated	bake
railings	balance
re-reading	balance
flamingoes	balance
gracefully	balance
prided	balanced
subdued	bald
curled	ball
theatrical	ballet
streamers	balloon
milkshake	banana
elastic	band
stony	bank
gorilla	bar
rattled	bar
floorboards	bare
moorland	bare
essentials	bare
wrestled	bare
mammoths	bare
skinned	bare
mildly	bargain
roam	bargain
birch	bark
rhythmically	bark
prehistoric	bark
encased	barn
cement	barn
erected	barrier
sportsman	barrier
foodstuffs	basic
homely	basic
paintwork	basically
scrubbed	basin
foregone	basis
rounders	bat
swooping	bat
bleach	bath
ensuite	bathroom
rechargeable	battery
medium-sized	battery
rejuvenate	battery
boardroom	battle
participle	be
ft	beak
pod	bean
cub	bear
majoring	bear
spontaneity	bear
precision	bear
grudges	bear
unprepared	bear
grudge	bear
costly	bear
nationalists	beat
immobilizing	beat
pigeons	beat
pelting	beat
slates	beat
cuisine	beat
exhale	beat
sting	bee
swarm	bee
stung	bee
brewed	beer
stunningly	begin
judo	beginner
bedtime	behave
schoolwork	behind
transnational	being
tango	belief
superstitions	belief
denominations	belief
chiming	bell
skyscraper	below
payers	belt
hysterically	bend
fir	bend
elucidate	bend
astronaut	benefit
benefited	benefit
non-smoking-area	benefit
scatter	berry
muesli	berry
buffet	besides
whip	best
suburban	best
baby-sitter	best
apron	bet
halfway	between
electro-magnetism	beyond
two-wheeled	bicycle
re-election	bid
bewilderment	bid
chairman	bid
motorcycle	bike
nationalist	bind
marine	biology
molecular	biology
caged	bird
flock	bird
ginger	biscuit
chalet	bit
maniac	bit
ok	bite
unpleasantly	bitter
multi-ethnic	black
chalk	blackboard
ingratitude	blackmail
soggy	bland
tape	blank
oblivious	blind
mute	blind
offerings	blind
insensitivity	blindness
nagging	blink
pillar	block
panoramic	block
repulsive	blood
trench	bloody
currents	blow
callousness	blow
assimilate	blow
morose	blue
roughened	blunt
hangings	board
walled	boast
preposterous	boat
downfall	boat
lotion	body
regulatory	body
centrally	body
puting	boil
climber	bold
mummies	bone
contention	bone
stand-offish	book
impractical	both
aquarium	bottom
inextricably	bound
civilized	boundary
heavyweight	boxing
tumour	brain
multilink	brake
kevlor	brake
motorcyclist	brake
marble	brass
yeast	bread
hamster	break
revisit	break
adolescence	break
rounded	breast
curses	breath
bated	breath
sportsmen	breath
enchanting	breath
airless	breathe
cherish	breed
familiarity	breed
rex	breed
spans	bridge
airy	bright
firemen	bright
mathematician	brilliant
bathed	brilliant
futile	bring
mobility	broadly
mosaics	bronze
framed	bronze
lily-pads	bronze
reeds	bronze
drenched	bronze
blended	bronze
richly	bronze
amber	bronze
palette	brush
stove	bubble
mop	bucket
tummy	bug
lodged	bullet
iced	bun
veggieburger	burger
firewood	burn
calories	burn
organism	burn
nearing	burn
arguably	burning
fiddle	burst
extinguish	burst
churchyard	bury
trotted	bury
butler	bury
intimacy	bury
scorching	bury
kaleidoscope	bush
swampy	bush
barren	bush
interviewer	butt
patterned	butterfly
blouse	button
noone	by
truckload	by
exorbitant	by
ambience	by
utensils	by
visualise	by
beforehand	by
manoeuvres	by
savoy	cabbage
attendant	cabin
glass-fronted	cabinet
overhead	cable
vexed	calculate
comical	calculate
endear	calculate
milked	calf
ewes	calf
backstage	call
mustered	call
opinon	call
breaths	calm
lakeside	camp
overworking	can
shipping	canal
uncontrolled	cancer
wax	candle
delinked	cap
hacked	capture
insulating	carbon footprint
footprints	carbon footprint
configuration	card
modem	card
multimedia	card
allergic	care
oyster	care
dangling	carrot
malaria	carry
flashy	carry
excellence	carry
sunburn	case
kayaking	case
unlawful	case
testimony	case
convincingly	case
classy	casserole
en	casserole
croute	casserole
cinematographic	cast
madness	cast
dreamless	cast
deliverance	catastrophe
ca	catch
lateness	catch
bicycling	catch
slacks	catch
curse	catch
trimmed	catch
shrubbery	catch
coffin	catch
grotesque	catch
languid	catch
hurled	catch
deluxe	category
shortlisted	cater
appetizers	catering
clots	cause
compact	CD
amaze	cease
lilac	ceiling
violet	ceiling
gamma	cell
symphony	cello
timpani	cello
vampires	cemetery
cm	centimetre
graduation	ceremony
attacker	certain
gleam	certain
masquerades	certainty
humiliation	challenge
cavaliers	challenging
succession	champion
immovable	chancellor
terrestrial	channel
dilapidation	chapel
revolves	character
elf	character
maiden	character
peoples	character
commission	charge
pistols	charge
thew	charge
blossom	charisma
`intense	charisma
rugged	charm
boyish	charm
smirks	chase
flimsy	chase
sometime	chat
camcorder	chatty
jackpot	check
deafening	cheer
fiancé	cheerful
sunflower	cheese
pledged	chemical
tonnes	chemical
sewage	chemical
petrochemicals	chemical
compounds	chemical
plasters	chemist
physicist	chemist
hairy	chest
indigestion	chew
sweeties	chew
cock	chicken
hen	chicken
ducklings	childish
belched	chimney
whiskers	chin
silicon	chip
cappuccino	chocolate
parsley	chop
nightly	chronic
fatigue	chronic
tautology	circular
falsified	circular
peple	civilian
ambush	civilian
convoy	civilian
verbally	clarity
afterthought	clarity
lipstick	clash
colonialists	clash
indigenous	clash
competitiveness	clash
aerobics	class
ii	classification
iii	classification
iv	classification
creators	classify
subordinate	clause
skies	clear
los	clear
multitude	clear
healthily	clear
wording	clichéd
motto	client
citrus	climate
unstable	climate
cot	climb
steeply	climb
ledge	cling
over-grazing	close
deforestation	close
degradation	close
resize	closeness
sauna	closeness
multi-storey	closure
greengrocer	closure
synthetic	cloth
massed	cloud
hormones	cloud
precedence	cloud
magician	clown
flush	clumsiness
dusting	clumsy
actress	clutch
accelerator	clutch
evading	clutch
ghostlike	coastline
batatas	cod
com	cod
bacalhau	cod
abide	coherent
afresh	coherent
playwright	coin
authenticism	coin
wallpaper	coincidence
optimize	collaboration
stalking	collapse
uncomplicated	colour
ambushes	combat
boredom	combination
cuddly	come
digitalized	come
overhelmed	come
acupuncture	come
shoelaces	come
liaison	come
grieved	come
spanking	comfort
perched	comfortable
shortcuts	command
console	command
sergeant-major	command
insurrection	command
militia	command
generals	command
solemn	commence
countenance	commence
microscope	commercial
chiefly	commitment
domino	commodity
dwellers	common
caterpillars	commonly
nettles	commonly
trafficking	community
senate	community
orienting	comparative
frenetically	comparison
gonna	compete
unquestionable	competence
archives	competence
shooter	competent
crossword	competition
findings	compile
shoppers	complex
appraisal	complicate
memorandum	complication
diabetes	complication
cardio-vascular	complication
mousse	compliment
chocolat	compliment
raspberries	compliment
liqueur	compliment
encryption	comply
concerto	composition
approx	composition
hrs	composition
smug	conceited
bumptious	conceited
miscarriages	conceive
minerals	concentration
conformity	conception
contingencies	conception
staffing	concern
toxins	concern
linguistics	concerned
troublemakers	concrete
consumerism	confirm
compulsion	confirm
methodical	confront
uvas	confuse
huevos	confuse
huevas	confuse
testicles	confuse
blast	confusion
engagement	congratulations
librarians	conjunction
imperialistic	conquer
pestering	conscience
adamantly	conscience
hardworking	conscientious
functioning	consecutive
manifestations	consent
fuddy-duddy	conservative
punctual	consider
brisk	consistent
airtight	container
mandatory	contempt
rapper	contest
bloodshed	context
blanked	context
celsius	continental
chairperson	continue
impoverished	contraception
shanty	contraception
bottled	contrary
enormously	contrast
sharpness	contrast
sweetness	contrast
skilfully	contrast
interwoven	contrast
blaze	control
savage	control
skidded	control
oncoming	control
hiss	control
dictator	control
bloke	conversation
cleanness	conversion
electrons	conversion
accordingly	convey
protesters	conviction
gig	cool
mega	cool
navigation	cool
eyed	coolness
reddish-brown	copper
reddish	copper
domes	copper
refinements	copy
reef	coral
scuba	coral
visibility	coral
reefs	coral
senator	core
trampled	core
stray	core
yams	corn
postbox	corner
multinational	corporation
expectancy	corresponding
invigilator	corridor
reel	cotton
blouses	cotton
serviettes	counter
tenets	counter
partying	country
plucked	courage
internship	course
interpersonal	course
penalized	court
speedy	courtesy
hillsides	cover
bodyguards	cover
autoracing	coverage
boastful	cowardly
lobsters	crab
everlasting	crack
speeding	crackdown
breaststroke	crawl
backstroke	crawl
outsider	craziness
yellowish-white	cream
moisturizing	cream
suntan	cream
tatami	cream
monks	cream
objectivity	credibility
manipulative	credibility
sportsmanship	credit
cookbooks	creep
lifeboat	crew
chirping	cricket
napkins	crisp
pastel	crisp
carpeting	crisp
adorned	crisp
autumnal	crisp
golds	crisp
outspoken	critic
crocodile-infested	crocodile
swamp	crocodile
commandments	cruelty
howling	crumble
fiercely	crumble
bulging	crumble
terminated	crush
conch	crush
seagulls	cry
shrub	cultivate
culinary	cultivate
nourishing	cultivate
negotiator	cultivate
teacup	cup
armaments	curb
bureaucratic	curb
racketeers	cure
meningitis	cure
curl	curly
curls	curly
thou	current
womanly	curve
bouquet	custom
moth	cycle
poultry	dairy
fractured	damaged
semi-colons	dash
blackcurrant	dash
datum	data
vitae	date
dusk	dawn
infestation	dawn
wildfire	dawn
roller	day
coasters	day
headlights	dazzle
spectacle	dazzling
stampede	death
centred	decade
caffeine	decaffeinated
stonework	decay
twelfth	December
skipper	deck
colonial	declaration
polls	decline
rainfall	decrease
bedroomed	dedicated
cornerstones	dedication
wonderfully	deep
immersion	deep
qualms	deep
thrust	deep
libellous	deepen
antlers	deer
counsel	defence
homeland	defend
karate	defend
fencing	defend
attorney	defend
conspicuous	defy
suspension	defy
bathing	degree
subordinates	delegate
translator	delegation
china	delicate
greenhouse	delicate
beloved	delicate
hamburgers	delicious
activists	demonstrate
compost	demonstrate
anti-war	demonstration
wooded	densely
ugliness	densely
lotions	deodorant
menace	dependence
vampire	depict
ore	deposit
digestive	deposit
economically	depressed
deviant	deprivation
grassy	descend
heighten	descendant
robber	description
graffiti	deserted
floral	design
co-designer	designer
tub	desirable
cheesecake	dessert
sufferings	detail
statistically	determine
multiply	devastating
computerization	developing
replenishing	devise
marital	devote
switchboard	dial
asthma	diarrhoea
shortsightedness	diarrhoea
monolingual	dictionary
ape	difference
aerial	difference
atrophy	difference
non-stop	differentiate
disobeying	dilemma
enchiladas	dim
candlelit	dinner
batter	dip
phrased	diplomatically
eg	direct
drainage	directly
aprons	dirty
bitterly	disappointed
redecorated	disappointment
deplorable	disapproval
respondents	disapprove
undecided	disapprove
cartilage	disc
precarious	disc
ligament	disc
doomed	disc
oblivion	disc
parental	discipline
maturity	discipline
jockeys	disc jockey
downtown	discount
overshadowed	discourage
patrols	discourage
premiere	discovery
impinges	discreet
personification	discretion
penalised	discriminate
imperfections	disguise
overpaid	disgust
dealings	dishonest
valueless	dishonestly
workmen	dismiss
angered	dismissal
maids	dismissal
tortilla	displace
submenu	display
manliness	display
gentleness	display
beep	disrupt
complacency	disruptive
antifungal	dissertation
rumbling	distant
gregarious	distant
dynamics	distinct
kerosene	distinct
sexes	distinction
ferocious	distinction
tenors	distinguish
flyers	distribute
merchandise	distribute
slowdown	distribution
oysters	dive
ethnically	diverse
alley	divide
polemic	divide
repayments	divide
deoxyribonucleic	DNA
tv	do
indignation	do
overreacting	do
aromatherapy	do
scented	do
erased	document
cute	doll
activated	domestic
olds	dominance
enlarge	dominant
metamorphosis	dominate
multinationals	domination
immortals	doom
penicillin	dose
www	dot
cambridge	dot
espresso	double
dreamer	down
yen	down
turbine	downwards
valve	downwards
canoe	drag
enchanted	drag
interminably	drag
courtroom	drama
reunification	drastically
ex-boyfriend	draw
chanting	draw
hordes	draw
mesmerise	draw
welled	draw
weariness	draw
shoplifting	draw
smartly	dress
rooftops	drift
waterhole	drink
capitalistic	drive
window-pane	drop
subscriptions	drop
boating	drown
anti-cancer	drug
fertility	drug
bass	drum
snare	drum
drummer	drum
monstrous	drunk
overcooked	dry
lucid	dry
kidnapped	dubious
webbed	duck
prejudicial	due
childrens	dull
mattress	dump
littering	dump
aviation	during
yellowed	dustbin
snuggled	duvet
awaited	eagerly
panda	eagle
cocker	ear
headway	ear
endlessly	ear
unfinished	ear
yardstick	early
disciplined	earn
focussed	earn
ploughed	earth
compass	east
mosaic	east
excitable	easygoing
godlike	eccentric
insanity	eccentric
neighing	echo
din	echo
hens	echo
piped	edge
paperback	edition
hardback	edition
anaesthetic	effect
kidnapper	effort
cuckoo	egg
hatch	egg
sizeable	egg
intravenous	elaborate
vial	elaborate
array	elaborate
rose-tinted	elated
daze	elated
bandaged	elbow
heroine	elder
enlighten	elder
chained	elder
sockets	electrician
skater	elegance
hydrogen	element
crust	element
discounted	eligible
elses	else
triffids	embody
mutation	embody
symbolising	embrace
pollutants	emission
correspondent	emotionally
intercultural	empathy
italics	emphasize
unstoppable	empire
trebled	employee
bookshelves	enable
parkland	enclose
tether	end
hurdle	endeavour
dichotomy	endorse
clubbing	energy
bitterness	enjoy
unsolicited	enough
tenth	enter
frank	enterprise
citizenship	entitle
coexistence	entity
prancing	entrance
limousine	entrance
electric-powered	environmentalist
thinning	environmentalist
adaptable	environmentally
spearheaded	environmentally
circa	envisage
imperial	equal
crampons	equip
paddling	era
imperfection	eradicate
factual	error
asylum	escape
hunters	escape
gooseberry	especially
thirdly	essential
sitar	essentially
brewery	establish
believer	ethic
euthanasia	ethical
paired	ethical
airbag	event
incumbent	event
perverse	eventual
catharsis	eventual
cogs	ever
uncontrollable	ever
teddy	everywhere
circumstantial	evidence
clinching	evidence
dependable	exaggerate
comprehension	examine
plums	example
spontaneous	example
personifies	example
schoolboy	example
borrowers	excellent
illogical	exception
parachuting	excitement
robust	exclaim
discern	exclusive
traitors	execute
naturalistic	exemplify
cadets	exercise
gruelling	exhaustion
wells	exist
cosmology	existence
emigrated	existence
sixteenth	existing
applicants	expect
relocation	expenses
reimbursed	expenses
enlarger	experiment
contributors	experiment
discard	experimental
nutritionists	experimental
sift	experimental
rental	expire
demominator	explosion
vapour	explosive
compound	explosive
pneumonia	exposure
forefinger	exquisite
loop	extend
peninsula	extend
diffused	extent
turtles	extinction
sunroof	extra
troop	extra
flabbergasting	extra
rabble	extra
autobiography	extract
wasteful	extravagant
bungee	extreme sports
rafting	extreme sports
anarchic	extremist
recommendable	eye
headmaster	eye
immoderate	eye
barefoot	eye
squealing	eye
wading	eye
bushy	eyebrow
drooped	eyelid
woollen	fabric
infringe	fabric
liberties	fabric
peg	face
clubhouse	fact
pinball-game	fact
roused	faint
fair-haired	fair
decency	fairness
truthfulness	fairness
multi-faith	faith
deconstruction	faithful
pseudonym	fake
alias	fake
slugs	fall
accommodated	fall
disuse	fall
creamy	fall
boulder	fall
communism	fall
budo-karate	familiar
knight	fancy
ie	far
christening	far
excursions	far
souks	far
multi-faceted	fascinated
exert	fascination
contentment	fast
unarmed	fatal
powerless	fate
gunman	fear
rescuers	fear
fighter	fearless
adrenaline	fearless
clone	feasible
entails	feast
peacock	feather
monastery	feather
marketplace	feature
disaffected	feature
decrepit	feeble
hamsters	feed
photocopier	feed
cop	feeling
splurging	feeling
vocalist	female
backyard	fertile
skyscrapers	fever
oats	fibre
archetypes	fictional
biochemistry	field
immaculate	field
lava	field
meteorites	field
beast	fierce
battered	fierce
fighters	fierce
wizards	fight
migrate	figure
impurities	filter
roadside	filter
burnished	filter
pecuniary	filter
dripping	filthy
pornography	filthy
cd	find
embarassing	find
koala	find
anthrax	fine
petri	fine
spores	fine
clumps	fine
sinister	finger
replayed	finish
handshake	firm
accountancy	firm
fins	fish
restoration	fit
leaden	fixed
beaming	fixed
cabaret	flair
mamma	flashback
parallelism	flashback
unfurnished	flat
rink	flat
dough	flatten
zillions	flavour
hippies	flavour
hairwraps	flavour
tattooing	flavour
limbs	flavour
thorns	flesh
gymnasts	flexible
agility	flexible
symphonies	flick
concertos	flick
merchants	flood
folkloric	flood
tiled	floor
loosely	floppy
cutest	floppy
arsenic	flour
optimally	flow
calcium-rich	fluid
narration	fluid
viola	flute
oboe	flute
spaceship	fly
co-workers	focus
insurmountable	follow
coma	follower
cranberry	foot
paella	for
prohibitively	for
underage	forbid
vile	force
battleground	force
picketing	force
refinery	force
blooming	force
vulgarity	foreign
ostrich	forget
abashment	forgiveness
ideological	form
puddle	form
mouthful	form
moist	form
yellow-tinted	form
bridegroom	formally
evaporates	formation
condenses	formation
ungifted	formerly
terminology	formula
rejoicing	fortune
persons	foul
reappeared	foul
inundated	fragrance
untold	fragrance
unique-styled	fragrance
embellish	fragrant
soothingly	frantic
bigamy	fraud
pesticides	free
sicknesses	free
siege	free
soups	freeze
mountainside	freeze
tropic	fresh
outback	fresh
stride	fright
lizards	frighten
hairbrush	from
gallon	from
seventeenth	from
villas	front
humankind	frontier
microwave	frozen
papayas	fruit
unleaded	fuel
esoteric	fulfilment
soothe	fulfilment
shotgun	full
breadwinner	full
festivities	fund
coca-cola	funny
eater	fussy
preciseness	fussy
pre-cooked	gain
lord	gamble
casino	gambling
kidnappers	game
robbers	gang
infamous	gang
excursion	gang
botanic	garden
clove	garlic
cloves	garlic
robes	garment
nitrogen	gas
juggler	gasp
dexterity	gasp
startled	gasp
barbeque	gathering
homosexual	gay
watchful	gaze
wrenched	gear
stormed	gear
neuter	gender
capsules	gene
artisans	generation
unrewarded	genius
councillors	get
loophole	get
squatters	get
houseguests	get
pun	get
flabby	giggle
junction	give
fallacy	give
glitter	glamour
communications	global
captivated	globe
afire	glow
humidity	glow
armpits	glow
perspire	glow
sellotape	glue
nailed	glue
urine	go
bluish	go
min	go
disregarding	go
dodge	go
goddesses	god
halo	god
blessed	god
mermaid	golden
savageness	good
lust	good
virginity	goodness
modesty	goodness
anti-violence	government
mugger	grab
magnolia	grace
impartial	graceful
absent-mindedly	grain
wineries	grape
crimson	grasp
nettle	grasp
immortality	grasp
grandmum	grateful
unmarked	grave
unquestioned	greatness
trademarks	greed
shrieks	greet
gaped	grim
gloomy	grim
corduroy	grin
poked	grin
greated	grin
booming	gross
granite	ground
infatuation	ground
molested	grounds
reggae	group
ska	group
proficiency	group
semester	group
maize	grow
seriousness	growing
disbelief	growing
deterioration	guarantee
patrolled	guard
dodgy-looking	guard
hound	guard
devotee	guidance
acoustic	guitar
trivialises	gulf
retaliate	guts
aqua	gym
overspending	habit
drumming	hail
escapism	hair
savour	hair
idleness	hair
microwaves	hairdryer
railcard	half-price
strangled	hand
formative	hand
amassing	hand
gratify	hand
fleeting	hand
caprices	hand
alleviate	hand
dabbed	handkerchief
mio	handkerchief
padre	handkerchief
monopolise	handsome
washer	handy
rack	hang
pulmonary	hang
woolly	hat
bigotry	hate
=there	have
measles	have
excessively	heart
drinker	heavy
horrors	heavy
inheritor	heir
attic	hell
oregano	herb
thyme	herb
rosemary	herb
cookery	herb
chattering	herb
architectural	heritage
deed	heroic
exploitation	heroic
reflexive	herself
applicant	hesitation
two-dimensional	hesitation
submissive	hierarchical
sped	high
sportswomen	high-profile
la	hill
timidly	hint
overcast	hint
drizzle	hint
trim	hip
dislocated	hip
enigma	historian
eighteenth-century	historical
motorcycles	hobby
sportswoman	hold
treasurer	hold
tugged	hold
legalization	hold
hideout	hollow
hedonism	hollow
golfer	home
banquet	honour
sanctuaries	honour
pavilion	hop
thwarting	hope
darkened	hopeful
collectively	horizon
dotted	horizon
projected	horizontal
axis	horizontal
beeped	horn
captors	horrifying
slums	hostile
outsiders	hostility
seafront	hotel
spacecraft	huge
likened	humanitarian
quagmire	humanitarian
compassion	humanity
mania	humility
tenderest	humour
amiable	humour
yuan	hundred
overpopulation	hunger
alligators	hunt
egotism	hypocrisy
incessant	hypocritical
blinded	hypocritical
enraged	hypocritical
vanilla	ice cream
kickboxing	icon
uncommunicative	icy
packaging	idea
watery	idea
unification	idea
brotherhood	idea
fingerprints	identification
apop	idol
pinky	if
newcomer	ignorant
ill-tempered	ill
shatter	illusion
homosexuality	illustrate
conjures	image
wares	image
motorsports	imitate
aristocracy	immensely
bard	immortal
flattery	immune
lupus	immune system
anti-bodies	immune system
anti-smoking	impact
soften	impact
wellbeing	implication
maid	implication
boiler	implication
di	important
hangovers	importantly
musings	impossible
professionalism	impressed
capricious	impulse
gymnast	in
pumpkins	in
divine	in
seatbelt	in
invoice	in
swaying	in
touchstone	in
co-educational	in
fulfill	in
affinity	in
tattoo	in
cannabis	in
fragment	in
refreshment	inappropriately
forgetful	inclined
academically	inclined
ex-soldiers	include
postage	including
mime	incorporate
rhematic	indefinite article
painfully	indefinitely
emanating	indefinitely
busters	independent
doorstep	indication
re-energised	indirectly
anxieties	indisputable
annihilate	individuality
degenerate	individuality
dreadfully	indulge
gratification	indulge
air-conditioner	inefficient
viruses	infect
mailbox	infect
epidemics	infectious
cholera	infectious
inflated	inferior
non-human	inferior
impeded	inferiority
inhibited	inferiority
twentieth	influence
piercings	informally
tattoos	informally
almonds	ingredient
insulin	injection
motivator	innate
childlike	innocence
barrage	innovation
acitivity	input
judicial	inquiry
epidemic	inquiry
accommodate	insane
criminally	insane
beetles	insect
pals	inseparable
cited	insofar as
understates	insofar as
beverage	installation
triumphed	instance
regrd	institution
wedlock	institution
coupled	instruction
expenditures	instruction
parameters	instruction
adhered	instruction
powered	instrument
repression	instrument
hurl	insult
glimmering	intellectual
toungue	intend
caressed	intensely
antagonism	intensify
seashell	intensity
sparkles	intensity
rubble	intensive
manipulate	interactive
gladly	interfere
aircrafts	interference
antenna	interference
dashboard	interior
intranet	internally
enmeshed	interval
cyclical	interval
cynic	intervene
hiking	intimate
lore	intimate
tidbits	intimate
cubes	into
scour	intriguing
outselling	introduction
vinyl	introduction
airing	introvert
persecuted	intruder
sanctuary	intrusion
hoards	invade
vacuum	inventor
kidnapping	investigate
radar	invisible
rusts	iron
stealth	ironic
contributor	ironically
hoovering	ironing
sarcasm	irony
skinny	irregular
prohibitions	irresponsible
hyperactive	irritate
sympathetically	issue
hasten	issue
ultimatum	issue
cheapness	its
financier	jail
raspberry	jam
apricot	jam
toner	jam
leche	jar
incomprehension	jealousy
mainland	join
ice-skaters	joint
postgraduate	journalism
kidding	joy
parenthood	joy
grapefruit	juice
carton	juice
eleventh	July
impenetrable	jungle
clerks	junior
alibi	jury
symbolize	justice
miscarriage	justice
captivity	justify
keenly	juvenile
spotlessly	keep
refrigerated	keep
can’t	keep
amazes	keep
lighthouse-keeper	keeper
dragons	keeper
positioning	key
saxophone	keyboard
snarled	kindly
tigress	kindly
claws	kindly
monarch	kingdom
altar	knee
forcefully	knock
instill	knowingly
unknowingly	knowingly
enigmatically	knowingly
grazed	knuckle
troublemaker	label
hot-blooded	label
unskilled	labour
originality	lack
fashioned	lady
newborn	lamb
bedside	lamp
drill	land
redefining	landmark
fags	language
malady	large
shooed	large
unreported	largely
lineage	last
nineteenth	late
transatlantic	launch
dockyard	launch
submarine	launch
martini	lavish
firearms	law
constrict	law
gravity	law
amenities	law
cogent	law
mow	lawn
stripped	layer
challengers	lead
blindly	lead
revolver	lead
pioneering	leadership
reappearance	leadership
audio	leading
gorillas	leaf
bounds	leap
unplugged	leave
ranch	leave
penniless	leave
manor	leave
unturned	leave
mythology	legend
discharged	legislation
rigorously	legislation
symbolizes	legitimate
democratically	legitimate
cds	lend
reconquer	lend
resurrection	lend
detested	lenient
buffalo	leopard
doorman	let
nutrients	level
disclaimed	liability
glucose	life
brightness	light
streaming	light
sth	lightly
yolk	lightly
runny	lightly
starter	like
thankyou	like
disconnected	line
bulletin	line
handhelds	line
foolishness	line
facade	line
taxation	line
reconnaissance	line
unwritten	line
interdisciplinary	line
toed	line
seams	linen
quilts	linen
perished	linger
bookstore	link
homepage	link
numeracy	literacy
rod	literal
figurative	literal
ceasefire	little
slum	little
parasitically	live
organisms	living
obscure	loathe
submission	loathing
devotion	loathing
galettes	local
inadvisable	local
overtaxed	longevity
gherkin	look
thenew	look
dyed	loose
agitated	lose
fundamentals	lose
hassle	lose
manuscript	loss
pre-tax	loss
madly	love
simmer	lower
unattended	luggage
miraculously	lure
magnet	magnetic
sceptics	maintain
scrutinizing	make
conglomerates	make
del	mall
isle	mammal
cleverest	man
procreate	man
mesmerized	mankind
folklore	mankind
pestered	march
polished	mark
milestone	mark
enlightenment	mark
enumeration	market
state-administered	market
distortions	market
kung	martial art
fu	martial art
surgical	mask
bewildered	mass
overdose	massive
tankers	massive
da	masterpiece
vintage	match
silky	material
incinerator	material
characterizes	materialism
kidnap	maximum
hesitantly	may
vastly	measure
barter	mechanism
hype	media
unbelievably	medication
spoonfuls	medicine
mealtimes	medicine
shallowness	mediocrity
epitomises	mediocrity
shareholders	meet
under-resourcing	meet
wayside	meet
instilling	meet
harp	melody
mid	melt
megabytes	memory
photographic	memory
recited	memory
jeweller	mend
octopus	mere
oppressions	merely
bankruptcy	merger
liquidation	merger
=judged	merit
platinum	metal
cubic	metre
cusp	millennium
modernized	millennium
dong	million
carbonated	mineral water
fizzy	mineral water
assortment	miniature
monocycle	miniature
netted	miniature
accordion	miniature
beneficiation	mining
magnesite	mining
scorned	minority
gigantic	minute
metallic	mirror
pigeon	miss
rifle	miss
dissident	missile
outing	missing
isolate	mission
sabotage	mission
disregard	misuse
paste	mix
raisins	mix
penetrating	modestly
gratitude	modestly
re-emerging	modestly
banknotes	money
modulation	monotonous
disintegrate	morale
commercially	motion
sailboat	motor
inboard	motor
availed	mount
reminisce	mount
mules	mount
optical	mouse
dj	move
feminist	movement
royalist	much
tablecloths	much
gravel	mud
fungus	mushroom
operas	musical
gangsters	musician
hugely	mutual
triple-storey	myself
clippers	nail
potholes	namely
wartime	narrative
theopposite	narrowly
sender	nasty
anthem	national
blackout	nationwide
flowering	native
irrefutable	naval
vessel	navy
adorable	neck
polo-neck	neck
thirtyish	neck
beige	neck
polo	neck
outfit	need
serviced	need
brightening	need
freak	need
proverbial	needless
ageing	negative
lax	negligent
equipted	negotiation
optic	nerve
mam	nerve
robins	nest
honeysuckle	nest
modernise	network
comfy	nice
interesing	night
shoved	nod
governor	nominate
ado	none
narrowness	normality
fringed	northeast
poking	nose
pickles	nostalgia
musty	nostril
stench	nostril
hairstyles	not
schoolmate	nothing
gourmet	nothing
otters	nothing
oversimplification	nothing
overfilled	noticeable
zealous	notwithstanding
fulfills	novelty
swerve	nowhere
nucleus	nuclear
disarmament	nuclear
indexed	number
departuring	number
skaters	numerous
psychiatric	nurse
sparrow	nurse
childminder	nursery
cashew	nut
allergy	nut
homemade	nutritional
comprehensible	objectively
herring	obligatory
innuendos	obscene
sociological	observe
cane	obtain
coronation	occasion
cigar	occasional
woodwork	occupation
irresponsibility	occur
confiding	oddly
re-elected	odds
stacked	odds
battlefield	odds
decidedly	odour
noodles	of
gape	off
towed-away	offence
sexist	offensive
uniformed	officer
anti-mafia	officer
martyrs	official
geniuses	often
sunflowers	olive
playgroup	on
impending	on
baggy	on
specialties	one
crates	onto
phonelines	open
flatmate	open
abused	open
counterfeit	open
dam	opening
dismissive	openly
peacekeeping	operation
reactors	operation
safari	operator
desirability	opinion
leavers	opportunity
vigorously	oppose
privatization	opposition
magenta	orange
cellist	orchestra
flip	order
reproductive	organ
enlightening	orientation
biking	other
canoeing	other
thundery	outbreak
incoming	outgoing
tiles	outline
entrants	outnumber
explorer	out of
tuxedos	out of
emigration	out of
migrant	outrage
opaque	oval
souvlaki	oven
geese	over
dictators	over
commentary	over
triumphantly	over
wrath	overcome
pressured	overtime
underweight	overweight
grandeur	overwhelm
hooting	owl
someday	own
wwwartcom	page
redecorating	painting
sweaty	palm
encore	palm
sociologists	panel
gunfire	panic
dog-sitter	paper
bilingualism	paper
dimensional	parallel
portal	parallel
demise	parallel
clan	parallel
disintegration	parallel
joggers	park
dishevelled	part
shimmering	part
kindergarten	partnership
overthrow	party
monarchy	party
three-pointer	pass
boyhood	passage
manhood	passage
adulthood	passage
conditionals	passive
bathe	past
ravioli	pasta
cannelloni	pasta
tortes	pastry
cherishes	patch
heirloom	patch
quilt	patch
allotment	patch
turnips	patch
beet	patch
darned	patch
airfield	path
platitudes	pathetic
leggings	pattern
behavioural	pattern
chimpanzees	pattern
tumbling	PC
furry	peach
apricots	peach
salted	peanut
soda	peanut
cider	pear
fortune-teller	peculiar
obliterated	peculiar
inscription	pedal
keyhole	peep
shaft	peer
violation	penalty
holders	penalty
neglectful	penalty
hundredth	pence
sharpener	pencil
popes	people
peppercorns	pepper
shutters	perceive
royalty	perception
motherly	perfect
adores	perfume
preschool	perk
hypermarket	permission
relativity	perseverance
drinkable	persist
inexcusable	persist
overreacts	personally
guinea	pet
prostitution	petty
hayfever	pharmacy
teens	phase
tidal	phenomenal
drunkenness	phenomenon
acorns	pick
tart	piece
crayons	piece
instrumental	piece
positioned	pile
foam	pillow
trouser	pin
durian	pineapple
moonless	pitch
criss-cross	pitch
hike	pitch
moors	pitch
toppings	pizza
housekeeper	place
consequent	plague
slaughtering	plague
progenitor	plague
violinist	platform
self-indulgence	platform
gratifying	platform
felony	plead
hitch	plead
scampering	pleasurable
nutritonists	plethora
diversified	plethora
strengtheners	plethora
wired	plug
incorrectly	plug
hillside	plunge
goose	plural
rucksack	pocket
efficent	pocket
vulgar	poetic
decimal	point
simulated	point
chatrooms	pointless
gallons	poison
ultra-violet	poisonous
countersignature	politically
gangster	politician
manifesto	pollution
non-poisonous	pony
videogames	pool
corks	pop
anthropology	popular
commissioned	portrait
overly	portrayal
hindsight	portrayal
kms	position
bossed	positively
deliberation	possession
commited	possession
rickety	posture
incapacity	posture
mashed	potato
tumours	potentially
clay	pottery
handmade	pottery
lbs	pound
ounces	pound
jumbo	pour
birthplace	poverty
outlaw	power
goverment	power
clinically	power
unnoticeable	practically
landfills	practice
affluence	pragmatic
turnout	precise
anacondas	predator
hurricane	predict
refutes	predominantly
syndrome	predominantly
un-	prefix
remuneration	pregnancy
uterus	pregnant
homosexuals	prejudice
sexuality	prejudice
escorted	premises
managerial	prepare
tranquillizers	prescribe
pollen	presence
hay	presence
haywire	presence
residing	presence
sapphire	present
lingerie	presently
lever	press
unsaid	press
campaigners	pressure
hydro-electric	pressure
transformer	pressure
voltage	pressure
ahigh	price
payfor	price
assassin	prime
beetle	prisoner
healthcare	private
cons	pro
wagged	proceed
dictatorship	proceedings
parliamentary	proceedings
unify	process
stinging	produce
proportioned	produce
emptied	produce
re-training	productivity
nick-nacks	productivity
bandaging	professional
sociology	professor
textile	profit
assimilating	profitable
esteemed	profitable
stimulation	profound
exerts	profound
psyche	profound
prologue	profound
pragmatism	profound
misguided	profoundly
utility	programming
gypsies	progress
karaoke	projection
happenings	projection
rep	promote
organisational	promotion
shah-day	pronounce
houseowner	property
straightaway	propose
importer	proposition
nationalistic	prosecution
divorcee	protagonist
miso	protein
mantelpiece	proudly
outcry	provoke
psychiatry	psychiatrist
surfers	publication
advertisers	publicity
stunt	publicity
toffee	pudding
flowerbeds	pull
manhole	pull
kin	pull
=count	pulse
goldfish	pump
expelled	punishment
legalized	purpose
multi-purpose	purpose
parlour	purpose
computing	pursue
shove	push
jigsaw	puzzle
chthonic	puzzle
bliss-endowed	puzzle
internalizing	puzzle
awakening	puzzle
fragments	puzzle
piecing	puzzle
incomplete	puzzle
clerk	pyjamas
triangular	pyramid
maternity	qualify
enhancement	quantity
ejected	questionable
pre-colonial	question mark
queueing	queue
hadn’t	quite
muses	quotation
swimsuit	race
pre-judging	racial
multi-cultural	racially
segregation	racism
blissful	racket
interupted	racket
pretentious	radical
stomped	rage
briskly	rage
flung	rage
narrates	rage
evacuated	rage
clad	raid
armour	raid
petite	range
punk-rock	rap
itchy	rash
baseketball	rate
sleepily	rather
sitcom	rather
leftovers	rather
sushi	raw
meaningless	ray
inflicted	reach
acold	readjust
attuned	readjust
modality	readjust
interface	readjust
anew	realm
sticker	rear
hard-hearted	reason
urbanized	rebuild
markedly	recent
wholemeal	recipe
racketeer	recognize
imaginable	recognize
depots	record
enamel	recreate
staffed	recreational
usefull	recruit
info	recruit
defamatory	rectify
flop	red
waterfront	redevelop
oldish	redundant
ex-managers	reference
thoughtfulness	reflection
lavished	reflection
flocks	refreshing
semi-desert	region
stupendous	regional
displeasure	register
minivan	regular
wagon	regular
seedlings	regular
hammered	reign
mis-understood	reject
growled	reject
motionless	rejection
they’re	related
commonsense	release
dvds	release
millenium	relentless
vouch	reliability
womens	rely
eternal	remarkable
attendants	remarkably
herbal	remedy
debatable	remedy
concomitant	render
wreak	render
havoc	render
hurriedly	renew
rejuvenation	renewal
paralyzed	repetition
bystander	repetition
superpowers	repetition
assassination	report
hereby	represent
proccedings	represent
exploiters	represent
tyranny	representation
simulators	reproduction
affordability	resemble
impetuous	resistance
wavered	resolve
toughened	resolve
tormentor	resourceful
inventive	resourceful
crow	resourceful
urgency	respectfully
unfixable	respectfully
canvas	rest
belittling	restrain
admirable	restraint
vexing	restraint
brainwash	retailer
assimilation	retention
hasty	retreat
interlinked	retreat
jailed	reveal
expanse	reveal
oust	revenge
freelancer	reverse
oversized	reversible
condescending	revolt
rags	riches
funfair	ride
bumpy	ride
extremism	right-wing
overripe	riot
thatched	riot
painstaking	rise
ideals	rise
rites	ritual
intimidating	rival
gunpoint	rob
majesty	rocky
hedgehog	roll
paprika	roll
holder	roll
coil	rope
terrain	rough
note-pad	rough
unkindly	roughly
thrashing	roughly
smacking	roughly
hometown	round
advantagous	route
oars	row
blazing	row
soles	rubber
alleys	rubbish
modernist	rule
artistry	rule
stationary	run
manly	run
dungeons	run
lurking	running
uncivilized	running
amad	rush
rust	rusty
repainted	rusty
morse	rusty
enshrined	sacred
sweatshop	sacred
paralysed	sad
lifeguard	safe
dinghy	sail
battleship	sail
moos	sail
billowing	sail
pagan	saint
risotto	salad
tinned	salmon
oily	salty
unprotected	same
linen-draped	same
suffice	same
nationally	sample
coarse	sand
fillings	sandwich
savoury	sauce
alien	save
retraining	saving
hatched	saying
abated	scarcely
re-editing	scare
gory	scare
daylights	scare
proclaimed	scare
horrific	scenario
re-united	scene
lesbian	scene
bloom	scent
astrology	sceptical
charter	scheduled
inexpensively	scholar
touchdown	score
mongrel	scrap
gnawing	scrap
trendy	scruffy
life-sized	sculpture
choppy	sea
pups	seal
perspiration	seal
undercover	search
patrol	search
congressional	seat
kickbacks	seat
cheaply	second
cocktail	secret
admirer	secret
oriented	sector
deported	security
cloned	security
agony	see
stupidly	see
sprouting	seed
unwisely	seed
dissidents	seek
beasts	seize
catalyst	self-awareness
commencement	self-awareness
antagonist	self-awareness
monologue	self-conscious
characterictics	self-discipline
underlies	self-esteem
appalled	selfishness
magically	self-reliance
empowered	self-reliance
strong-willed	self-reliant
marginalise	self-sufficient
powerfull	sell
airmail	send
reinforcements	send
untidiness	send
duet	send
coaster	sensational
aesthetic	sensibility
objectiveness	sensitivity
catchy	sentimental
compartment	separate
yolks	separate
apartheid	separation
daylong	separation
re-used	sequence
graphical	sequence
prequel	sequence
revamping	sequence
tranquillity	serenity
rapist	serial
tarts	serve
custard	serve
whipped	serve
replanting	serve
recorder	set
wrongfully	set
indulgent	set
boxed	set
stuntperson	set
glittering	setting
lenders	settle
farmlands	settlement
embroidering	sewing
adversaries	shabby
sha	shall
beech	shallow
anti-dandruff	shampoo
massage	shampoo
lather	shampoo
shareholder	share
pre-rendered	sharp
accomodate	sharp
insolent	sharp
discourteous	sharp
preoccupied	shed
long-haired	sheep
lochs	sheep
acquainted	sheer
stark	sheer
crammed	shelf
snail	shell
tortoise	shell
campers	shield
ravage	shield
toting	shield
barbarians	shield
well-pampered	shield
harshness	shield
malnutrition	shield
radiantly	shine
bliss	shine
merchant	ship
striped	shirt
long-sleeved	shirt
high-heeled	shoe
lace	shoe
reels	shoot
hypothetically	shoot
familiarisation	shorten
awfully	short-sighted
themedia	short-sighted
forehand	shot
shouldn’t	should
apes	show
puppet	show
wintry	shower
flushed	shrug
pedestrianised	shuttle
work-fellows	shyness
chatter	sideways
noisily	sigh
clockwork	sight
trusty	signal
cameraman	signal
efficacy	simplicity
interpreters	simultaneous
overalls	sin
battleships	sink
wailing	siren
demolition	sixty
hectares	size
inline	skate
stunts	sketch
dressmaking	skilled
batsman	skull
crunchy	skull
receiver	slam
natives	slang
idiomatic	slang
bbccouk	slash
sickened	slaughter
abolition	slavery
humane	sleeve
nowdays	slice
thinly	slice
ballroom	slip
depletion	slow
looting	smash
drunken	smile
puff	smoke
nicotine	smoking
cocaine	smuggle
venom	snake
twigs	snap
tendon	snap
vodka	sneak
cornflakes	snob
ruby-red	snow
surfboard	snowboard
crackling	so
mince	so
obscured	soak
upended	soak
hovering	soar
carefreeness	sober
joie	sober
vivre	sober
arrogance	socialism
multicultural	society
wrongs	society
grounding	solid
contemplation	solitude
cellphone	somebody
mummy	something
svelte	sophisticated
blessing	sorrow
alphabetically	sort
tolling	sound
equator	south
backbone	southeast
plough	sow
diabetics	soya
neccessary	spade
headmistress	speak
outfits	specialize
non-native	specification
explorers	specimen
designated	specimen
blinding	spectrum
inkling	speculate
contemplations	speculate
rousing	speech
punk-music	speech
watersports	speed
starters	spirit
sects	spiritual
vengeance	spite
puddles	splash
raindrops	splash
marvelled	splendour
towered	splendour
cloudless	splendour
paled	splendour
insignificance	splendour
majestic	splendour
breadcrumbs	split
grease	spot
buttered	spread
workable	spread
fostered	spread
aimlessly	sprinkle
incarcerating	squad
academy	squad
quirk	squander
brownies	square
cyan	squeaky
reloaded	squeeze
federation	stability
editorial	staff
drunkenly	stagger
wearily	stagger
squelching	stagger
jeering	stamp
pout	stamp
tenderly	stamp
rankings	stand
treason	stand
exacerbating	stand
greenery	stand
incite	standard
refrigerator	standard
twinkled	star
arsonists	start
mower	start
repairman	start
shaky	start
roaming	starving
warranty	state
pre-nuptial	statement
entice	state-of-the-art
erect	statue
shadowed	status
reasoned	steady
simmering	steam
stew	steam
stainless	steel
mistreated	stepfather
kibidango	stepmother
seeker	stereotypical
flaunting	stereotypical
undeserved	stereotypical
deter	stern
maliciously	stern
campfire	stick
non	stiff
brandy	stiff
gin	stiff
tonic	stiff
advantageous	stimulus
motivational	stimulus
mesmerizing	stir
rationale	stir
miniskirts	stocking
fishnet	stocking
bachelor	stone
pad	stone
three-legged	stool
cafeteria	stool
conditioner	stop
daddy	story
alcoholism	story
grocer	story
optician	strain
tucked	strand
unwrapped	strap
ofexperience	strategy
bluff	strategy
unrealised	straw
teahouse	stream
passers-by	stream
viability	strength
intonation	stress
automobile	strict
mindful	strict
frivolous	strike
blight	strike
plantation	strike
filed	striking
arena	strive
valiantly	strive
hydrodynamics	stroke
adoration	stroke
lovingly	stroke
vineyard	stroll
egoistic	strong
infuriated	stubbornness
mule	stubbornness
undergraduate	student
sweetener	study
doctorate	study
briefcase	stuff
cramp	style
consciously	subconsciously
wishful	subconsciously
beatings	subject
interrogations	subject
nightmarish	subsequently
radiators	subtle
lollipop	suck
slander	sue
helpings	suffer
unnaturally	sufferer
acutely	sufferer
semifinal	sufficiently
warrant	sufficiently
-ness	suffix
alarmingly	suicide
pinstripe	suit
nightfall	summit
heliboarding	summit
bomoh	summon
exorcise	summon
pontianak	summon
deeds	superficial
breastfeeding	superior
bottlefeeding	superior
lifeguards	supervision
moonlighting	supplement
outstrips	supply
locally	support
dome	support
pillars	support
petition	support
writings	suppose
assassins	supposedly
ex-husband	sure
lice	surgery
gall-stone	surgery
facillities	surrounding
midwives	survey
hydropower	sustainable
mitigate	sustainable
helplessness	swallow
gliding	swan
signets	swan
duckling	swan
colourless	sweat
beads	sweat
sleeved	sweatshirt
avalanche	sweep
dynamite	sweep
riffs	swift
quell	swiftly
bruised	swollen
double-edged	sword
advancements	sword
gamos	syllable
fraternity	symbolic
impassive	sympathy
filing	system
metric	system
cosmetic	system
rationalization	systematic
grubby	tabloid
ramble	tact
clergymen	tact
shrieked	tactless
grammatically	take
good-natured	take
engraved	take
accompaniment	tangible
chorus	tangible
interviewees	task
aptitude	task
dishwater	taste
tequila	taste
refurbished	tasteful
polluters	tax
transit	taxi
netball	team
glides	technical
engineered	technically
marvels	technically
configurable	technically
loudspeakers	technician
redecoration	temporarily
betweeen	tension
hindrance	term
minibus	terminal
conquerors	territory
intimidated	terrorist
hairspray	test
immunity	testify
earthly	theoretically
meteorite	theory
roadworks	theory
tsikondia	therapeutic
physiologist	therapist
physiotherapist	therapist
yearly	thereafter
doctoral	thesis
moor	thick
marsh	thick
pumping	thigh
lurks	thin
computer-freaks	think
scribbling	think
satire	thoroughly
hastily	thoughtless
bitchy	thoughtless
nightthat	threshold
mummified	throne
ascended	throne
vigorous	throne
undercooked	through
profusely	throw
tenacity	throw
punctuating	tick
screws	tighten
bathtub	tighten
harvested	time
multiplied	times
cyborguards	tin
silvery-coloured	tin
porter	tip
palate	to
marmalade	toast
extremes	tolerate
conditioners	tolerate
sweetcorn	tomato
jokey	tone
screwdriver	tool
modelling	tool
grit	tooth
caramel	top
hazelnut	top
executioner	torture
trickle	toss
overthrew	totalitarian
bargaining	tough
accustom	toughness
haze	toxic
contaminated	trace
shellfish	trace
comradeship	trace
unreleased	track
involuntary	track
settlers	trade
freight	traffic
naivety	trait
likeable	trait
shattering	tranquility
energetically	tranquility
reorganization	transform
oversee	transition
bone-marrow	transplant
pipeline	transport
snowy	trap
smithereens	tread
begetting	treaty
humiliates	treaty
scapegoat	treaty
superstitious	tremble
methodology	trend
equilateral	triangle
bouquets	tribute
syrup	trick
bowling	trick
exterminate	trilogy
motorboat	trip
adversity	triumph
eradication	triumph
smallpox	triumph
spurt	triumph
snooker	trophy
unprofitable	troubled
overturned	truck
believers	true
aforementioned	trustworthy
pathway	tunnel
inventory	turnover
twelve-seater	twelve
morality	twisted
sparkle	type
dizziness	typical
idolatry	unaffected
hedonistic	unanimously
despising	unbiased
starched	uncomfortably
rowdy	unconscious
exhilarating	unconventional
unsuccessfuly	uncover
detonator	under
counterbalance	under
moles	underground
habitation	unfit
fraught	unfold
insinuations	unfold
speech-impaired	unimaginable
handicap	unimaginable
workbook	unit
anti-terrorist	unit
rejoin	unit
adored	universally
extinguished	universe
sociologist	unmarried
stewardess	unpleasant
waterpolo	unpopular
improper	unprofessional
inattentive	unprofessional
lag	unqualified
simulate	unreal
credible	unreal
mob	unsafe
ups	unsure
fluffy	until
idyllic	untouched
latch-key	unwanted
distinctly	upper-class
glamorous	upper-class
catwalks	upper-class
evaporation	upwards
anti-government	upwards
wi-fi	usefulness
polio	vaccinate
hepatitis	vaccinate
decor	vaguely
rediscover	value
grievances	vandalism
bores	vanity
puncture	various
renaissance	vast
parsnips	vegetable
unhurt	vehicle
sombre	velvet
mourning	velvet
haven	vent
ranting	vent
raving	vent
fuming	vent
animosity	vent
frequented	venture
scintillating	versatile
jocular	versatile
chronological	versus
cog	veteran
dieting	vicious
rooftop	view
palatial	view
oppresses	view
punks	view
criminality	violence
townships	virtual
exponential	virtual
overcrowding	virtue
comet	visible
higly	visible
blur	vision
wwwartclasscom	visit
removal	vital
audacious	vivacious
repaint	vivid
re-unify	voice
discharge	volcano
unpunctual	wait
eye-lashes	wander
symbolised	wardrobe
hunched	warehouse
telework	warehouse
spears	warrior
bloodthirsty	warrior
mixer	waste
grumbling	waste
patriots	wave
kidnappings	wave
paves	way
probe	way
pave	way
ponytail	wear
inject	weary
wwwluna@it	web
wwwcambridgeorg	website
overgrown	weed
heaviness	weigh
kg	weight
outstay	welcome
outstayed	welcome
fable	what
yellowish	wheat
darts	while
barley	whisky
inns	whisky
distillery	whisky
malt	whisky
white-haired	white
co-worker	whose
preservatives	widespread
beverages	wildly
foster	wildly
debaters	wildly
conditional	will
meadows	wind
flapping	wing
librarian	witch
elixir	witch
assassinated	witness
mill	working
erecting	worsen
synagogue	worship
improperly	worship
gramophone	worthless
duly	worthy
gunshot	wound
implicated	wound
wits	wrap
salvage	wreck
littered	wreck
devastate	wreck
cockpit	wreckage
loneliest	wrinkled
distinguishable	writing
erroneous	wrongly
wanna	yellow
gracious	yet
sweetened	yogurt
masala	yogurt
chappaties	yogurt
mini-skirts	young
mastering	youngster
